# Class / Struct
ESP8266                            	KEYWORD1
ESP8266Connection                  	KEYWORD1
ESP8266Station                     	KEYWORD1
ESP8266Client                      	KEYWORD1
ESP8266Server                      	KEYWORD1

# Method
begin                              	KEYWORD2
setTimeout                         	KEYWORD2
test                               	KEYWORD2
restart                            	KEYWORD2
getVersion                         	KEYWORD2
deepSleep                          	KEYWORD2
setBaudrate                        	KEYWORD2
setMode                            	KEYWORD2
getMode                            	KEYWORD2
joinAP                             	KEYWORD2
getAP                              	KEYWORD2
listAP                             	KEYWORD2
quitAP                             	KEYWORD2
setAPConfiguration                 	KEYWORD2
getAPConfiguration                 	KEYWORD2
getConnectedStations               	KEYWORD2
setDHCP                            	KEYWORD2
setMAC                             	KEYWORD2
getMAC                             	KEYWORD2
setIP                              	KEYWORD2
getIP                              	KEYWORD2
getConnectionStatus                	KEYWORD2
connect                            	KEYWORD2
send                               	KEYWORD2
close                              	KEYWORD2
setMultipleConnections             	KEYWORD2
getMultipleConnections             	KEYWORD2
createServer                       	KEYWORD2
deleteServer                       	KEYWORD2
setServerTimeout                   	KEYWORD2
getServerTimeout                   	KEYWORD2
available                          	KEYWORD2
getId                              	KEYWORD2
read                               	KEYWORD2
peek                               	KEYWORD2
flush                              	KEYWORD2
begin                              	KEYWORD2
connect                            	KEYWORD2
available                          	KEYWORD2
read                               	KEYWORD2
write                              	KEYWORD2
peek                               	KEYWORD2
flush                              	KEYWORD2
stop                               	KEYWORD2
connected                          	KEYWORD2

# Enum
ESP8266_WIFI_STATION               	LITERAL1
ESP8266_WIFI_ACCESSPOINT           	LITERAL1
ESP8266_WIFI_BOTH                  	LITERAL1
ESP8266_ENCRYPTION_OPEN            	LITERAL1
ESP8266_ENCRYPTION_WEP             	LITERAL1
ESP8266_ENCRYPTION_WPA_PSK         	LITERAL1
ESP8266_ENCRYPTION_WPA2_PSK        	LITERAL1
ESP8266_ENCRYPTION_WPA_WPA2_PSK    	LITERAL1
ESP8266_CONNECTION_GOT_IP          	LITERAL1
ESP8266_CONNECTION_CONNECTED       	LITERAL1
ESP8266_CONNECTION_DISCONNECTED    	LITERAL1
ESP8266_PROTOCOL_TCP               	LITERAL1
ESP8266_PROTOCOL_UDP               	LITERAL1
ESP8266_ROLE_CLIENT                	LITERAL1
ESP8266_ROLE_SERVER                	LITERAL1
ESP8266_COMMAND_INVALID            	LITERAL1
ESP8266_COMMAND_TIMEOUT            	LITERAL1
ESP8266_COMMAND_OK                 	LITERAL1
ESP8266_COMMAND_NO_CHANGE          	LITERAL1
ESP8266_COMMAND_ERROR              	LITERAL1
ESP8266_COMMAND_NO_LINK            	LITERAL1
ESP8266_COMMAND_TOO_LONG           	LITERAL1
ESP8266_COMMAND_FAIL               	LITERAL1
